XXXXXXXXXX
XXXX_____X
X________X
X________X
X____O___X
X________X
X_O______X
X________X
X____XXXXX
XXXXXXXXXX